####################
#              #   #
# ####### # ## # ###
# #   #   #  #     #
# # # # ########## #
#   # #          # #
##### ########## # #
#@#       #      # #
# ####### ## # ### #
# #     # #### # # #
#   ### #    # #   #
##### # ###### # # #
#     #    #     # #
# #######  ##### #@#
#                # #
####################
